8 0 0 0 0 0 0 0 0 0 0 1 2 2 0 0
8 0 0 0 0 0 0 0 0 0 2 1 1 2 2 0
8 0 0 0 0 0 0 0 0 1 2 2 0 0 0 0
8 8 8 0 0 0 0 0 0 0 1 1 2 2 0 0
0 0 8 8 8 8 10 0 0 0 0 0 0 0 0 0
0 0 0 0 0 0 9 3 3 0 0 0 0 0 0 0
0 0 0 0 0 0 0 0 3 3 3 8 0 0 0 0
0 0 0 0 0 0 0 0 0 0 0 8 8 0 0 0
0 0 0 0 0 0 0 0 0 0 0 0 8 0 0 0
0 0 0 0 0 1 1 2 2 0 0 0 8 0 0 0
0 0 0 0 0 0 1 2 0 0 0 0 8 0 0 0
0 0 0 0 0 0 0 0 0 0 0 0 8 0 0 0