14 0 0 0 0 0 0 0 0 0 16 1 2 2 0 0
14 0 0 0 0 0 0 0 0 16 2 1 1 2 2 0
14 0 0 0 0 0 0 0 16 1 2 2 0 0 0 0
11 13 15 0 0 0 0 0 0 16 1 1 2 2 0 0
0 0 11 13 13 13 10 0 0 0 0 0 0 0 0 0
0 0 0 0 0 0 9 3 3 0 0 0 0 0 0 0
0 0 0 0 0 0 0 0 3 3 3 15 0 0 0 0
0 0 0 0 0 0 0 0 0 0 0 11 15 0 0 0
0 0 0 0 0 0 0 0 0 0 0 0 14 0 0 0
0 0 0 0 16 1 1 2 2 0 0 0 14 0 0 0
0 0 0 0 0 16 1 2 0 0 0 0 14 0 0 0
0 0 0 0 0 0 0 0 0 0 0 0 14 0 0 0