19 12 14 14 14 14 14 14 14 14 14 1 2 2 14 18
15 12 0 0 0 0 0 0 0 3 2 1 1 2 2 17
15 12 0 0 0 0 0 0 3 1 2 2 0 0 0 17
15 9 13 0 0 0 0 0 0 3 1 1 2 2 0 17
15 0 9 11 11 11 13 0 0 0 0 0 0 0 0 17
15 0 0 0 0 0 12 0 0 0 0 0 0 0 0 17
15 0 0 0 0 0 9 4 4 4 4 4 13 0 0 17
15 0 0 0 0 0 0 0 0 0 0 0 12 0 0 17
15 0 0 0 0 0 0 0 0 0 0 0 12 0 0 17
15 0 0 0 3 1 1 2 2 0 0 0 12 0 0 17
15 0 0 0 0 3 1 2 0 0 0 0 12 0 0 17
20 16 16 16 16 16 16 16 16 16 16 16 12 16 16 21