0 12 0 0 0 0 0 0 0 0 3 1 2 2 0 0
0 12 0 0 0 0 0 0 0 3 2 1 1 2 2 0
0 12 0 0 0 0 0 0 3 1 2 2 0 0 0 0
0 9 13 0 0 0 0 0 0 3 1 1 2 2 0 0
0 0 9 11 11 11 13 0 0 0 0 0 0 0 0 0
0 0 0 0 0 0 12 0 0 0 0 0 0 0 0 0
0 0 0 0 0 0 9 4 4 4 4 4 13 0 0 0
0 0 0 0 0 0 0 0 0 0 0 0 12 0 0 0
0 0 0 0 0 0 0 0 0 0 0 0 12 0 0 0
0 0 0 0 3 1 1 2 2 0 0 0 12 0 0 0
0 0 0 0 0 3 1 2 0 0 0 0 12 0 0 0
0 0 0 0 0 0 0 0 0 0 0 0 12 0 0 0